1111111111111111
1000000000000001
1000000000C00001
1C00000100000E01
100001110P000001
100C000000000001
1000000011100001
100000000C100001
1111111111111111
