111111111
1000C0P01
1C0010E01
111111111