111111111111111111
100000000000000001
10000000000C000P01
1C000000100000E001
100001111000000001
100C00000000000001
100000000111000001
1000000000C1000001
111111111111111111
