1111111111111111111111
1000000000000000000001
10000000000000C000P001
1C000000000100000E0001
1000000011110000000001
1000C00000000000000001
1000000000001110000001
1000000000000C10000001
1111111111111111111111
