111111111111
10001C00P001
100000000C01
1C0000E00001
111111111111