1111111
1C000E1
1P01111
10000001
1111111