1111111111
1001000P01
1001000001
100011E001
1111111111