111111011
1001C00P1
1C0011E01
111111111