111111111
1001C00P1
1C0011E01
100P00C01
111111111